2 0
5 4
6
0 14
14 0
12 13
2 4
3 7
4 14

0 0 0 1 1 0 0 0 0 1 0 0 0 1 0
1 0 0 0 0 0 0 1 1 0 0 1 1 1 0
1 0 1 0 0 1 0 1 0 0 1 1 0 0 0
1 1 1 0 1 1 1 1 1 0 1 1 0 0 1
1 0 1 0 1 0 1 1 0 0 0 1 0 0 1
0 0 0 0 0 0 1 0 0 0 0 0 1 0 0
1 1 0 0 1 0 0 0 1 1 0 1 1 0 0 
0 0 0 0 1 0 1 1 1 0 0 1 1 0 0
0 1 0 0 1 0 1 1 1 1 0 0 0 0 1
0 1 0 0 1 1 1 0 0 1 1 0 0 0 1
0 1 0 1 0 0 1 1 0 1 1 0 0 0 1
0 0 0 0 0 1 1 0 0 0 1 1 0 0 0
0 1 1 0 1 0 0 0 1 0 0 1 1 0 0
0 0 0 0 0 0 1 1 1 0 0 0 0 0 1
0 0 1 1 0 1 1 2 1 0 1 1 0 0 1