1 2
7 7
6
0 10
11 0
10 13
14 7
0 7
8 11
0 0 0 0 0 0 0 0 0 0 0 0 0 0 0
1 0 1 0 1 0 1 0 1 1 1 0 1 1 1
1 0 1 0 1 0 1 0 1 0 0 0 0 1 0
1 1 1 0 1 0 1 0 1 1 1 0 0 1 0
1 0 1 0 1 0 1 0 0 0 1 0 0 1 0
1 0 1 0 1 1 1 0 1 1 1 0 0 1 0
0 0 0 0 0 0 0 0 0 0 0 0 0 0 0
0 0 0 0 0 0 0 0 0 0 0 0 0 0 0
1 1 0 1 1 1 0 1 1 1 0 1 1 1 0
0 1 0 1 2 1 0 1 2 1 0 1 0 0 0
0 1 0 1 1 1 0 1 1 1 0 1 1 1 0
0 1 0 0 0 1 0 0 0 1 0 1 2 1 0
0 1 0 1 1 1 0 1 1 1 0 1 1 1 0
0 0 0 0 0 0 0 0 0 0 0 0 0 0 0
1 0 1 0 1 0 1 0 1 0 1 0 1 0 1