7 0
6 9
6 
2 0
12 0
0 14
11 9
1 7
12 13

0 0 0 0 0 0 0 0 0 0 0 0 0 0 0 
1 1 1 0 1 1 1 0 1 0 1 0 1 1 1
1 0 0 0 1 2 1 0 1 1 0 0 0 1 0
1 1 1 0 1 1 1 0 1 0 0 0 0 1 0
2 2 1 0 1 0 0 0 1 1 0 0 0 1 0
1 1 1 0 1 0 0 0 1 0 1 0 0 1 0
0 0 0 0 0 0 0 0 0 0 0 0 0 0 0 
0 0 0 0 0 0 0 0 0 0 0 0 0 0 0
0 1 0 1 1 1 0 0 1 1 1 0 1 1 1
1 1 0 1 2 1 0 0 1 0 0 0 0 0 1
0 1 0 1 1 1 0 0 1 1 1 0 1 1 1
0 1 0 0 0 1 0 0 1 2 1 0 1 2 2
0 1 0 1 1 1 0 0 1 1 1 0 1 1 1
0 0 0 0 0 0 0 0 0 0 0 0 0 0 0 
0 1 0 1 0 1 0 1 0 1 0 1 0 1 0
 