2 2
7 8
6
0 0
10 0 
4 4
5 12
11 11
6 14
0 0 0 0 0 0 0 0 0 0 0 0 0 0 0
0 1 0 1 0 1 0 0 1 0 1 0 0 1 0
0 1 0 1 0 1 0 0 1 0 1 0 0 1 0
0 0 0 0 0 0 1 0 0 0 0 0 1 0 0
0 0 0 0 0 0 0 0 0 0 0 0 1 0 0
1 1 1 1 1 0 1 0 1 1 1 0 1 1 1
1 0 1 0 1 0 1 0 1 0 1 0 1 0 1
1 0 1 0 1 0 1 0 1 0 1 0 1 0 1
0 0 0 0 0 0 0 0 0 0 0 0 0 0 0
0 1 1 0 0 1 1 0 0 1 1 0 0 1 1
0 0 0 0 0 0 0 0 0 0 0 0 0 0 0
0 0 1 1 1 1 0 1 1 1 1 0 1 1 1
0 0 0 1 0 0 0 1 0 0 0 1 0 0 0
0 1 0 1 0 1 0 1 0 1 0 1 0 1 0
0 1 0 0 0 1 0 0 0 1 0 0 0 1 0