2 4
6 7
6
0 0
14 0
2 11
11 11
7 0
7 14

0 0 0 0 1 0 0 0 0 0 1 0 0 1 0
1 0 0 1 0 0 1 1 0 0 0 1 0 0 0
0 0 1 0 0 1 0 0 1 0 0 0 1 1 0
0 1 0 0 1 1 0 0 0 1 0 0 0 1 0
0 0 0 1 0 0 0 1 0 0 1 0 0 0 0 
0 0 1 0 0 1 0 0 1 0 0 1 0 0 0
0 1 0 0 1 1 1 0 0 1 0 0 1 0 0
0 0 1 0 0 1 0 0 1 0 0 1 0 0 0
0 0 0 1 0 0 1 1 0 0 0 0 0 0 0
1 0 0 0 1 0 0 0 0 1 0 0 0 0 1
0 1 0 0 0 1 0 0 1 0 0 0 0 1 0
0 0 0 0 0 0 1 1 0 0 0 0 1 1 0
0 1 1 1 0 0 0 0 0 0 0 1 0 0 0
0 1 0 0 1 0 0 0 0 0 1 0 0 1 0
0 0 0 0 1 1 0 0 0 0 0 0 0 1 0