2 1
7 6
6
0 4
12 3
0 14
14 14
11 11
5 10

2 1 0 0 0 0 0 0 0 0 0 0 0 1 0
1 1 0 0 1 1 1 0 1 1 1 0 0 1 1
0 0 0 0 0 1 0 0 0 1 0 0 0 0 0
0 0 0 0 1 1 1 0 0 1 0 0 0 0 0
0 0 0 0 0 0 0 0 0 0 0 0 0 0 0
0 0 1 0 1 1 1 0 0 0 1 0 1 1 1
0 1 0 0 1 2 1 0 0 1 0 0 1 2 1
1 1 1 0 1 2 1 0 1 1 1 0 1 2 1
0 0 1 0 1 2 1 0 0 0 1 0 1 2 1
0 0 1 0 1 1 1 0 0 0 1 0 1 1 1
0 0 0 0 0 0 0 0 0 0 0 0 0 0 0
1 1 0 1 1 0 1 1 0 0 0 0 0 1 1
0 1 0 0 1 0 0 0 0 1 0 1 0 0 0
0 1 1 0 1 1 0 1 1 1 0 1 1 1 0
0 0 0 0 0 0 0 1 0 0 0 0 0 1 0